111111111111111111111111111111111
100101000000000000000000001111101
101000000000001111100000000000111
1100111111000000000000000000000E1
111111111111111111111111111111111
