NO ../assets/textures/NO.xpm
SO ../assets/textures/SO.xpm
WE ../assets/textures/WE.xpm
EA ../assets/textures/EA.xpm

F 220,100,0
C 225,30,0

1111111111111111111111111
1N0001000000100000000011
1011101110111011101111011
1000100000100001000100011
1110111011101110111011011
1000001000000001000000011
1011111011111111111111011
1000000010000000100000011
1110111010111011101111011
100010001010N010001000011
1011101110111010111011011
1000001000000010000000011
1111111111111111111111111
