11111111
 10000001
  1000  01
100000011
11111N11
