1111111111111
1010101010101
1101010101011
1010101010101
1101N10101011
1010101010101
1101010101011
1111111111111
