11111111111
10000000001
10111111101
101     101
101  1  101
101     101
10111111101
10000N00001
11111111111
