1111111111111111111
1000100010001000001
10 010 010 010 0001
1000100010001000001
10 010 010N010 0001
1000100010001000001
10 010 010 010 0001
1000100010001000001
1111111111111111111
