111111111111111
100000000000001
100001111100001
100001   100001
10S001111100001
100000000000001
111111111111111
