                      111111
                 111111000001
            111111000000000001
       111111000000000000000001
  111111000000000000N000000001
       111111000000000000000001
            111111000000000001
                 111111000001
                      111111
