111111111111111
100000000000001
101111111111101
101000000001101
101011111101101
101010N01101101
101011111101101
101000000001101
101111111111101
100000000000001
111111111111111
